###.#####.#L#
#*#.# * #.#R#
#*#.# * #.#\#
# #.#   #.#\#
# #.#   #.#\#
#  .     ..\#
###.#####.###
   
